%%%%%%%%%%%%%%%%%%%%%%%%%%%%%%
%.%       %     %%%       % .%
% %%  % %%%%%%%     %  %%%%% %
% %   %   % %   % %%%%    %  %
% % %%%%% %     %   %   %%%  %
% %   %     %%%%%%  % %%%    %
%   %    % %%P%         % %  %
%%%%%%% %%  %   %  %  %   %%%%
% %   %     % %%% %%%%%%% %  %
% % %%%%%%%     %  %  %   %  %
%       % %%%%  %    %%%%    %
%%% %%  %      %%%%%  % %%%  %
%.   %    %%%         %     .%
%%%%%%%%%%%%%%%%%%%%%%%%%%%%%%
