%%%%%%%%%%%%%%%%%%%%%%%%%%%
%                        P%
%     %%%%%%%%%%%%%%%%    %
%           % % %         %
%           % % %         %
%           % % %         %
%           % % %         %
%           % % %         %
%%%%%%%%%%  % % %         %
%           % % %         %
%   %       %%%%%         %
%   %   %   % % %         %
%   %   %   % % %         %
%   %   %     % %         %
%   % %%%%%%%%%%%         %
%   %   %     %           %
%  %%%%%%     %           %
%   %   %     %           %
%   %   %                 %
%   %   %                 %
%   %   %   %%%%%%%%%%%%% %
%   %   %                 %
%   %   %      %%%%%%     %
%   %                     %
%       %%                %
%.                        %
%%%%%%%%%%%%%%%%%%%%%%%%%%%
