%%%%%%%%%%%%%%%%%%%%%%%%%%%%%%
%.%       %     %%%       % .%
% %%  % %%%%%%% %   %  %%%%% %
% %   %     %   % %%%%    %  %
% % %%%%%%%     %   %   %%%  %
% %         %%%%%%% %%% %    %
%   %P%  %%%%   % %   % % %  %
%%%%% % %%  % %   % %     % %%
% %   %     % %%%%%%% %%%%%  %
% % %%%%% %     %     %   %% %
%       % %%%%% %  % %%%%    %
%%% %%  %       % %%  % % %% %
%    %  % %%%%%    %       % %
%    %        %%% %%%  % %%%%%
%%% %%% % %%%     %    %   % %
%   %   % % % %%%%%%%%%%%%%% %
% %%%%% % %   %   %    %     %
%   %     % %%%%  %  %    % %%
% %    % %% %       %%%% %%  %
%%% % %%  %   %  %     %     %
%   % % % % %%% %%%% %%% % % %
% %%% % %%    %  %       % %%%
%.    % %  %  %    %%%%  %  .%
%%%%%%%%%%%%%%%%%%%%%%%%%%%%%%