%%%%%%%%%%%%%%%%%%%%
%. %     %      % .%
%    % %%%%%%%% %% %
%%%%%% %P%    %    %
% %    %   %%   %  %
% %% % %%%  %%% %% %
%.   %       %   %.%
%%%%%%%%%%%%%%%%%%%%
